01 01 01 01 01 01 01 01 01 01 01 01 01 01 01 01 01 01 01 01 01 01 01 01 01 01 01 01 01 01 01 01 01 01 01 01 01 01 01 01 01 01 01 01 01 01 01 01 01 01 01 01 01 01 01 01 01 01 01 01 01 01 01 01 01 01 01 01 01
01 70 01 00 00 00 01 00 00 00 00 00 01 00 00 00 00 00 00 00 00 00 00 00 00 00 00 00 00 00 01 00 00 00 00 00 00 00 01 00 00 00 00 00 00 00 00 00 00 00 00 00 00 00 00 00 01 00 00 00 00 01 00 00 00 01 71 01 01
01 00 01 00 01 00 01 00 01 00 01 01 01 00 00 01 01 01 01 01 01 01 01 00 00 01 01 01 18 19 01 01 01 01 01 01 01 01 01 18 19 01 01 01 00 01 01 01 01 01 01 01 01 01 00 00 01 01 01 00 00 01 00 01 00 01 00 01 01
01 00 00 00 01 00 01 00 01 00 01 00 00 00 00 01 18 19 00 00 00 00 01 00 00 01 00 00 20 21 00 00 00 00 01 00 00 00 00 20 21 00 00 01 00 01 00 00 00 00 00 18 19 01 00 00 00 00 01 00 00 01 00 01 00 00 00 01 01
01 01 01 01 01 01 01 00 01 00 01 00 00 01 01 01 20 21 00 00 01 00 01 00 00 01 00 00 01 00 01 00 01 01 01 01 01 00 01 00 01 00 00 01 00 01 00 01 00 00 01 20 21 01 01 01 00 00 01 01 00 01 01 01 01 01 01 01 01
01 00 00 00 00 00 00 00 00 00 01 00 00 00 00 00 00 01 00 00 01 00 00 00 00 01 00 00 01 00 01 00 00 00 00 00 00 00 01 00 01 00 00 01 00 00 00 01 01 00 01 00 00 00 00 00 00 00 01 00 00 00 00 00 00 00 00 01 01
01 00 01 01 01 01 00 01 01 00 01 00 00 01 01 01 01 01 00 01 01 00 00 00 00 00 00 00 01 00 01 01 01 01 01 01 01 01 01 00 01 00 00 00 00 00 00 01 00 00 01 01 01 01 01 01 00 00 01 00 01 01 01 01 01 01 00 01 01
01 00 00 00 00 00 00 00 00 00 00 00 00 00 00 00 00 01 00 00 01 00 00 01 01 01 01 01 01 00 00 00 00 00 00 00 00 00 00 00 01 01 01 01 01 01 00 01 00 01 01 00 00 00 00 00 00 00 00 00 00 00 00 00 00 00 00 01 01
01 00 01 01 01 01 00 01 00 00 01 01 01 01 01 01 00 01 01 00 01 00 00 01 00 00 00 00 00 00 01 01 01 01 01 01 01 01 01 00 00 00 00 00 00 01 00 01 00 00 01 00 00 01 01 01 01 01 00 00 01 00 00 01 01 01 00 01 01
01 00 00 00 00 01 00 01 00 01 01 00 00 00 00 01 00 01 00 00 01 00 00 01 00 00 01 01 01 01 01 00 00 00 01 00 00 00 01 01 01 01 01 00 00 01 00 01 01 00 01 00 00 01 00 00 00 01 01 00 01 00 00 01 00 00 00 01 01
01 01 01 01 01 01 01 01 00 00 00 00 00 00 00 01 00 01 00 01 01 00 00 01 00 00 00 00 00 00 01 00 01 01 01 01 01 00 01 00 00 00 00 00 00 01 00 01 00 00 01 00 00 01 00 00 00 00 00 00 01 01 01 01 01 01 01 01 01
01 46 47 48 49 50 51 01 01 01 01 01 01 01 00 01 00 01 00 00 01 00 00 01 00 01 01 01 00 00 01 00 01 00 00 00 01 00 01 00 00 01 01 01 00 00 00 01 00 01 01 00 00 01 00 00 01 01 01 01 01 22 23 24 25 26 27 01 01
01 52 53 54 55 56 57 01 00 00 00 00 00 00 00 00 00 01 01 00 01 00 00 00 00 01 00 00 00 00 01 00 01 01 00 01 01 00 01 00 00 00 00 01 00 00 00 01 00 00 01 00 00 00 00 00 00 00 00 00 01 28 29 30 31 32 33 01 01
01 58 59 60 61 62 63 01 00 00 01 01 01 01 01 01 00 01 00 00 01 01 01 01 01 01 00 00 01 01 01 00 01 00 00 00 01 00 01 01 01 00 00 01 01 01 01 01 01 00 01 00 00 01 01 01 01 01 01 00 01 34 35 36 37 38 39 01 01
01 64 65 66 67 68 69 01 00 00 00 00 00 00 00 01 00 00 00 00 01 00 00 00 00 01 00 00 00 00 00 00 01 00 01 00 01 00 00 00 00 00 00 01 00 00 00 00 01 00 00 00 00 01 00 00 00 00 00 00 01 40 41 42 43 44 45 01 01
01 01 01 01 01 01 01 01 01 01 01 01 01 01 01 01 01 01 01 00 00 00 01 00 00 01 01 01 01 01 01 01 01 00 00 00 01 01 01 01 01 01 01 01 00 01 00 00 01 00 01 01 01 01 01 01 01 01 01 01 01 01 01 01 01 01 01 01 01
01 00 00 00 00 00 00 00 00 00 00 00 01 72 01 00 00 00 01 00 00 00 01 00 00 00 00 01 00 00 00 00 01 01 00 01 01 00 00 00 01 00 00 00 00 01 00 00 00 00 01 00 00 00 01 74 01 00 00 00 00 00 00 01 00 00 00 01 01
01 00 00 01 01 01 01 01 00 00 01 00 01 73 01 00 01 00 01 01 01 01 01 00 01 01 01 01 00 01 01 01 01 00 00 00 01 01 01 00 01 01 01 01 00 01 01 01 01 01 01 00 01 00 01 75 01 00 00 01 01 01 01 01 01 01 00 01 01
01 00 00 00 00 00 00 00 00 00 01 00 01 00 00 00 01 00 00 00 00 00 01 00 00 00 00 01 00 01 00 00 00 00 00 00 00 00 01 00 01 00 00 00 00 01 00 00 00 00 00 00 01 00 00 00 01 00 00 00 00 00 00 00 00 00 00 01 01
01 01 01 01 01 00 00 00 01 01 01 00 01 01 01 01 01 01 01 01 01 00 01 00 00 01 00 01 00 01 00 01 01 01 01 01 01 00 01 00 01 00 00 01 00 01 00 00 01 01 01 01 01 01 01 01 01 00 01 01 01 00 00 01 01 01 01 01 01
01 00 00 00 00 00 00 00 18 19 01 00 00 00 00 00 00 00 00 00 00 00 00 00 00 01 00 01 00 01 00 00 00 01 01 00 00 00 01 00 01 00 00 01 00 00 00 00 00 00 00 00 00 00 00 00 00 00 01 18 19 00 00 00 00 00 00 01 01
01 00 01 01 01 01 01 01 20 21 01 01 01 00 00 01 00 00 01 01 01 00 01 01 01 01 00 01 00 01 00 01 00 00 00 00 01 00 01 00 01 00 00 01 01 01 00 00 01 01 01 00 00 01 00 00 01 01 01 20 21 01 01 01 01 01 00 01 01
01 00 01 00 00 00 00 01 00 00 00 00 00 00 00 01 00 00 00 00 01 00 00 00 00 00 00 00 00 01 01 01 01 00 00 01 01 01 01 00 00 00 00 00 00 00 00 00 01 00 00 00 00 01 00 00 00 00 00 00 00 01 00 00 00 01 00 01 01
01 00 01 01 01 00 00 01 01 01 01 01 01 01 01 01 01 01 00 00 01 00 00 01 01 01 01 00 00 00 01 00 00 00 00 00 00 01 00 00 00 00 01 01 01 01 00 00 01 00 00 01 01 01 01 01 01 01 01 01 01 01 00 01 01 01 00 01 01
01 00 00 00 00 00 00 00 00 00 00 00 01 00 00 00 00 01 00 00 01 00 00 00 00 01 00 01 01 01 01 00 00 00 00 00 00 01 01 01 01 00 00 01 00 00 00 00 01 00 00 01 00 00 00 01 00 00 00 00 00 00 00 00 00 00 00 01 01
01 00 01 01 01 00 00 01 00 00 01 00 01 00 00 01 00 01 00 00 01 01 01 00 00 01 00 01 00 00 01 00 00 00 00 00 00 01 00 00 01 00 00 01 00 01 01 01 01 00 00 01 00 01 00 01 00 00 01 00 01 00 00 01 01 01 00 01 01
01 00 01 00 00 00 00 01 01 00 01 00 01 01 00 01 00 01 00 00 18 19 01 00 00 01 00 01 00 00 01 00 00 00 00 00 00 01 00 00 01 00 01 01 00 01 00 00 00 00 00 01 00 01 00 01 00 01 01 00 01 00 00 00 00 01 00 01 01
01 00 01 00 01 01 01 01 00 00 01 00 01 00 00 01 00 01 00 01 20 21 01 00 01 01 00 01 01 01 01 00 00 00 00 00 00 01 01 01 01 00 00 01 00 01 18 19 01 01 00 01 00 01 00 01 00 00 01 00 01 00 00 00 00 01 00 01 01
01 00 01 00 00 00 00 00 00 00 01 00 01 00 01 01 00 00 00 01 01 00 01 00 00 01 00 00 00 00 01 00 00 00 00 00 00 01 00 00 00 00 00 00 00 00 20 21 01 00 00 00 00 01 00 01 01 00 01 00 01 01 01 01 00 01 00 01 01
01 00 01 00 01 01 01 01 00 01 01 00 01 00 00 01 00 00 00 00 01 00 00 00 00 00 00 01 01 01 01 00 00 00 00 00 00 01 01 01 01 01 00 01 01 01 01 01 01 00 00 00 00 01 00 01 00 00 01 00 00 00 00 00 00 01 00 01 01
01 00 01 00 00 00 00 01 00 00 01 00 00 00 00 01 01 01 00 00 01 01 01 01 01 01 00 00 00 00 01 00 00 00 00 00 00 01 00 00 00 00 00 00 00 00 00 00 00 00 01 01 01 01 00 00 00 00 01 00 01 01 01 01 00 01 00 01 01
01 00 01 00 00 00 00 01 01 00 01 01 01 01 01 01 00 01 00 00 00 00 00 00 00 00 00 00 01 00 01 00 00 00 00 00 00 01 00 00 01 00 00 01 00 00 00 00 00 00 01 00 00 01 01 01 01 01 01 00 01 00 00 00 00 01 00 01 01
01 00 01 01 01 01 00 01 00 00 01 00 00 00 00 01 00 01 01 01 01 01 01 01 00 01 01 00 01 00 01 00 00 00 00 00 00 01 00 01 01 01 00 01 00 00 01 01 01 01 01 01 00 01 00 00 00 00 01 00 01 00 00 01 01 01 00 01 01
01 00 00 00 00 01 00 01 00 01 01 00 01 00 00 01 00 01 00 00 00 00 00 00 00 01 00 00 01 00 01 00 00 00 00 00 00 01 00 00 01 00 00 01 00 00 00 00 00 00 01 00 00 01 00 01 00 00 01 00 01 00 00 01 00 00 00 01 01
01 00 01 00 00 01 00 01 00 00 01 00 01 01 00 01 00 01 00 00 01 01 01 00 00 01 18 19 01 01 01 00 00 00 00 00 00 01 01 01 01 00 01 01 00 01 01 01 00 00 01 00 01 01 00 01 01 00 01 00 01 00 00 01 00 01 00 01 01
01 00 01 00 00 00 00 01 01 00 00 00 01 00 00 01 00 01 00 00 00 00 01 00 01 01 20 21 00 00 01 00 00 00 00 00 00 01 00 00 00 00 00 01 00 01 18 19 00 00 01 00 00 01 00 01 00 00 00 00 01 00 00 00 00 01 00 01 01
01 00 01 01 01 01 00 01 01 01 01 00 01 00 01 01 00 01 01 01 01 00 01 00 00 01 01 01 01 00 01 00 02 03 04 05 00 01 00 01 01 01 01 01 00 01 20 21 01 01 01 01 00 01 00 01 00 01 01 01 01 00 01 01 01 01 00 01 01
01 00 00 00 00 00 00 00 00 00 00 00 01 00 00 00 00 00 00 00 00 00 01 00 00 00 00 00 00 00 01 00 06 07 08 09 00 01 00 00 00 00 00 00 00 01 00 00 00 00 00 00 00 00 00 01 00 00 00 00 00 00 00 00 00 00 00 01 01
01 00 00 01 01 01 01 01 01 01 01 01 01 01 01 01 01 01 01 01 01 01 01 01 01 01 01 01 01 01 01 00 00 00 00 00 00 01 01 01 01 01 01 01 01 01 01 01 01 01 01 01 01 01 01 01 01 01 01 01 01 01 01 01 01 00 00 01 01



